00 02 02 02 02 02 02 02 02 02 02 02 02 02 02 02 02 02 02 02 02 02 02 02 02 02 02 02 02 02 02 02 02 02 02 02 02 02 02 02 02 02 02 02 02 02 02 02 02 02 02 02 02 02 02 02 02 01 
15 30 30 30 30 30 30 30 30 30 30 30 30 30 30 30 30 30 30 30 30 30 30 30 30 30 30 30 30 30 30 30 30 30 30 30 30 30 30 30 30 30 30 30 30 30 30 30 30 30 30 30 30 30 30 30 30 03 
15 30 24 26 25 30 24 26 26 26 26 26 26 26 25 30 24 26 26 26 26 26 26 26 26 26 26 26 26 26 25 30 24 26 26 26 26 26 26 25 31 34 22 35 30 24 26 26 26 25 30 24 26 26 26 25 30 03 
15 42 36 26 37 30 27 31 31 31 31 31 31 31 27 30 36 26 26 26 26 26 26 26 26 26 26 26 26 26 37 30 36 26 26 26 26 26 26 37 31 23 31 23 30 36 26 26 26 37 30 36 26 26 26 37 42 03 
15 30 30 30 30 30 27 31 24 26 26 26 26 26 37 30 30 30 30 30 30 30 30 30 30 30 30 30 30 30 30 30 31 31 31 31 31 31 31 31 31 23 31 23 30 30 30 30 30 30 30 30 30 30 30 30 30 03 
12 14 14 14 25 30 27 31 27 30 30 30 30 30 30 30 08 10 10 10 10 10 09 30 32 38 38 38 38 38 33 31 28 14 14 43 43 14 14 29 31 23 31 23 30 08 10 10 10 10 10 09 30 24 14 14 14 13 
31 31 31 31 15 30 27 31 27 30 24 26 26 26 25 30 11 31 31 31 31 31 11 30 39 31 31 31 31 31 39 31 03 31 31 31 31 31 31 15 31 23 31 23 30 11 31 08 10 09 31 11 30 03 31 31 31 31 
02 02 02 02 37 30 27 31 27 30 36 26 25 31 27 30 11 31 08 10 09 31 11 30 39 31 32 38 33 31 39 31 03 31 31 31 31 31 31 15 31 23 31 23 30 11 31 20 10 21 31 11 30 36 02 02 02 02
31 31 31 31 31 30 27 31 27 30 30 42 27 31 27 30 11 31 11 31 11 31 11 30 39 31 39 31 39 31 39 31 03 31 31 31 31 31 31 15 31 23 31 23 30 11 31 08 10 10 10 21 30 31 31 31 31 31 
14 14 14 14 25 30 27 31 36 26 26 26 37 31 27 30 11 31 20 10 21 31 11 30 39 31 44 38 45 31 39 31 40 02 02 02 02 02 02 41 31 23 31 23 30 11 31 11 30 30 30 30 30 24 14 14 14 14 
31 31 31 31 15 30 27 31 31 31 31 31 31 31 27 30 11 31 31 31 31 31 11 30 39 31 31 31 31 31 39 31 31 31 31 31 31 31 31 31 31 23 31 23 30 11 31 20 10 10 10 09 30 03 31 31 31 31 
00 02 02 02 37 30 36 26 26 26 26 26 26 26 37 30 20 10 10 10 10 10 21 30 44 38 38 38 38 38 45 31 24 26 26 26 26 26 26 25 31 46 22 47 30 20 10 10 10 10 10 21 30 36 02 02 02 01 
15 30 30 30 30 30 30 30 30 30 30 30 30 30 30 30 30 30 30 30 30 30 30 30 30 30 30 30 30 30 30 30 36 26 26 25 24 26 26 37 30 30 30 30 30 30 30 30 30 30 30 30 30 30 30 30 30 03 
15 30 24 26 26 25 30 24 26 26 26 26 26 26 26 26 25 30 24 25 30 24 26 26 26 26 26 26 26 26 25 30 30 30 30 27 27 30 30 30 30 24 26 26 26 26 26 26 26 25 30 24 26 26 26 25 30 03 
15 30 36 26 26 37 30 36 26 26 26 26 26 26 26 26 37 30 27 27 30 36 26 26 26 26 26 26 26 26 37 30 24 25 30 36 37 30 24 25 30 36 26 26 26 26 26 26 26 37 30 36 26 26 26 37 30 03 
15 42 30 30 30 30 30 30 30 30 30 30 30 30 30 30 30 30 27 27 30 30 30 30 30 30 30 30 30 30 30 30 27 27 30 31 31 30 27 27 30 30 30 30 30 30 30 30 30 30 30 30 30 30 30 30 42 03 
12 14 14 14 14 14 14 14 14 14 14 14 14 14 14 14 14 14 17 19 14 14 14 14 14 14 14 14 14 14 14 14 17 19 14 14 14 14 17 19 14 14 14 14 14 14 14 14 14 14 14 14 14 14 14 14 14 13 

  
